{
  "id":"00",
  "columns":12,
  "rows"   :9,
  "cell_size" : 16,
  "scene_title" : "Main World",

  "tile_map_image" : "tilemap.png",
  "portals" : [


  ],


  "graphical_map":[
                     39,39,39,39,39,39,39,39,39,39,39,39,
                     39,39,39,39,39,39,39,39,39,39,39,39,
                     39,39,39,39,39,39,39,39,39,39,39,39,
                     39,39,39,39,39,39,39,39,39,39,39,39,
                     39,39,39,39,39,39,39,39,39,39,39,39,
                     39,39,39,39,39,39,39,39,39,39,39,39,
                     39,39,39,39,39,39,39,39,39,39,39,39,
                     39,39,39,39,39,39,39,39,39,39,39,39,
                     39,39,39,39,39,39,39,39,39,39,39,39,
                     39,39,39,39,39,39,39,39,39,39,39,39
                  ],

  "collision_map":[
                    0, 0, 0, 0, 0, 0, 0, 0, 0, 0, 0,0,
                    0, 0, 0, 0, 0, 0, 0, 0, 0, 0, 0,0,
                    0, 0, 0, 0, 0, 0, 0, 0, 0, 0, 0,0,
                    0, 0, 0, 0, 0, 0, 0, 0, 0, 0, 0,0,
                    0, 0, 0, 0, 0, 0, 0, 0, 0, 0, 0,0,
                    0, 0, 0, 0, 0, 0, 0, 0, 0, 0, 0,0,
                    0, 0, 0, 0, 0, 0, 0, 0, 0, 0, 0,0,
                    0, 0, 0, 0, 0, 0, 0, 0, 0, 0, 0,0,
                    1, 1, 1, 1, 1, 1, 1, 1, 1, 1, 1,1
                  ]


}
